NO ./resources/north-texture
SO ./resources/south-texture
WE ./resources/west-texture
EA ./resources/east-texture
F 220,100,0
C 225,30,0

11111
10N01
10E01
10001
11111
