NO ./resources/north-texture
SO ./resources/south-texture
WE ./resources/west-texture
EA ./resources/east-texture
F 220,100,0
C 225,30,0

11111
10001
10E01
10000
11111
